18
# # # # # # # # # # # # # # # # # #
# O # # . # # # # . . . # # # # # #
# . # # . # # # # . # # # # # . . X
# . # # . # # # # . . . # # # . # #
# . # # . . . . . . # . # # # . # #
# . # # # # . # # # # . # # # . # #
# . # # # # . # # . . . # # # . # #
# . # # # # . # # # # . . . . . # #
# . # # . # . . # # # # # # # # # #
# . # # . # # . # # # # # # # # # #
# . # # . . . . . . . . . . # # # #
# . # # # # # # # # # # # . . . # #
# . # # # # # # # # # # # # # . # #
# . . . . . . . . . . . # # # . # #
# # # # # # # # # # # . # # # . # #
# # # # # . . . . . . . . . . . # #
# # # # # . # # # # # # # # # # # #
# # # # # # # # # # # # # # # # # #